.................................
.................................
....TT........................T..
.....T...........................
.....TTTTT.............TTTTTT....
.......T..................T......
.......T............TT....T......
.......T.............T....T......
.................................
..........................T......
..........................T..TT..
.TTTTTT.TTTT.................T...
........................T........
........................TTTT.....
..TT.....................T.......
...T.....................T.......
...T.............................
......TTTT....T......TT..........
.................................